##########
#   ..   #
#   oo   #
# p      #
##########